# # # # # # # # # # #
# . . . . . . . . . #
# . # # # # # # # . #
# . . . . . . . # . #
# . # . . . . . # . #
# . # . . . . . # . #
# . # . . . . . # . #
# . # . . . . . # . #
# . # # # # # # # . #
# . . . . . . . . . #
# # # # # # # # # # #