# # # # #
# . . . #
# . . . #
# . # . #
# # # # #