# # # # # # # # # 
# . . . . . . . #
# . . # # # # . #
# . . . . . # . #
# . . . . . # . #
# # # # . . # . #
# . . . . . # . #
# . . . . . # . #
# . . # # # # . #
# . . . . . . . #
# . . . . . . . #
# # # # # # # # #